,team,points,goals_for,goals_against,wins,goals_diff,tie_points,tie_goals
1,KC,32,25,27,9,-2,0,0
2,POR,31,39,20,8,19,0,0
3,SD,31,29,19,9,10,0,0
4,HOU,30,32,24,8,8,3,4
5,CHI,30,32,24,8,8,0,1
6,RGN,28,24,18,7,6,0,0
7,LA,26,20,20,7,0,0,0
8,NC,25,39,31,7,8,0,0
9,ORL,21,20,37,5,-17,0,0
10,LOU,17,19,31,3,-12,0,0
11,WAS,16,22,26,2,-4,0,0
12,NJNY,12,13,37,4,-24,0,0
