,team,points,goals_for,goals_against,wins,goals_diff,tie_points,tie_goals
1,KC,33,25,27,9,-2,0,0
2,POR,32,39,20,8,19,0,0
3,SD,32,29,19,9,10,0,0
4,HOU,31,32,24,8,8,4,4
5,CHI,31,32,24,8,8,1,1
6,RGN,29,24,18,7,6,0,0
7,LA,27,20,20,7,0,0,0
8,NC,26,39,31,7,8,0,0
9,ORL,22,20,35,5,-15,0,0
10,WAS,17,22,26,2,-4,0,0
11,LOU,15,17,31,2,-14,0,0
12,NJNY,13,13,37,4,-24,0,0
