,team,points,goals_for,goals_against,wins,goals_diff,tie_points,tie_goals
1,POR,38,46,21,10,25,0,0
2,RGN,37,29,19,10,10,0,0
3,KC,36,29,28,10,1,0,0
4,SD,34,30,19,10,11,0,0
5,HOU,33,33,26,9,7,0,0
6,NC,31,46,33,9,13,0,0
7,CHI,30,32,28,8,4,0,0
8,LA,29,22,22,8,0,0,0
9,ORL,21,20,40,5,-20,0,0
10,WAS,19,25,31,3,-6,0,0
11,LOU,17,19,34,3,-15,0,0
12,NJNY,12,13,43,4,-30,0,0
